Snap Out Of It - Arctic Monkeys - AM
make up sex (feat. blackbear) - mgk, blackbear - mainstream sellout
Bad Habits (feat. Bring Me The Horizon) - Ed Sheeran, Bring Me The Horizon - Bad Habits (feat. Bring Me The Horizon)
maybe (feat. Bring Me The Horizon) - mgk, Bring Me The Horizon - mainstream sellout
EDGING - blink-182 - EDGING
jawbreaker - mgk - Tickets To My Downfall
Bed Of Roses - Bon Jovi - Keep The Faith (Remastered)
Running in the Night - FM-84, Ollie Wride - Atlas
forget me too (feat. Halsey) - mgk, Halsey - Tickets To My Downfall
Your Body Is a Wonderland - John Mayer - Room For Squares
fake love don't last (feat. iann dior) - mgk, iann dior - mainstream sellout
See You Again (feat. Kali Uchis) - Tyler, The Creator, Kali Uchis - Flower Boy
why are you here - mgk - why are you here
Perfectly Lonely - John Mayer - Battle Studies
Snake Eater - Cynthia Harrell - METAL GEAR 20th ANNIVERSARY METAL GEAR MUSIC COLLECTION
There's Nothing Holdin' Me Back - Shawn Mendes - Illuminate (Deluxe)
BABY GODDAMN - Tananai - BABY GODDAMN
New Light - John Mayer - Sob Rock
why you gotta kick me when i'm down? - Bring Me The Horizon - amo
DANCE WITH ME - blink-182 - ONE MORE TIME...
Bad Medicine - Bon Jovi - New Jersey (Deluxe Edition)
When I See You Smile - Bad English - Bad English
Whatsername - Green Day - American Idiot
Jaws - Sleep Token - Jaws
Wheel - John Mayer - Heavier Things
Something Like Olivia - John Mayer - Born and Raised
Who Did You Think I Was - Live at the Nokia Theatre, Los Angeles, CA - December 2007 - John Mayer - Where the Light Is: John Mayer Live In Los Angeles
Baby Don't Cry - NASKA - Baby Don't Cry
COMINCIA TU (feat. Rosa Chemical) - Tananai, Rosa Chemical - COMINCIA TU (feat. Rosa Chemical)
It's My Life - 2003 Acoustic Version - Bon Jovi - It's My Life (2003)
Suck It and See - Arctic Monkeys - Suck It and See
Slow Dancing in a Burning Room - Live at the Nokia Theatre, Los Angeles, CA - December 2007 - John Mayer - Where the Light Is: John Mayer Live In Los Angeles
Face Me - The Plot In You - Swan Song
Enemy - The Plot In You - Swan Song
Good Looking - Suki Waterhouse - Good Looking
Aqua Regia - Sleep Token - Aqua Regia
Be Kind (with Halsey) - Marshmello, Halsey - Be Kind (with Halsey)
Disappearing Boy - Green Day - 1039/Smoothed Out Slappy Hours
Going to Pasalacqua - Live at Cricket Wireless Amphitheatre, Chula Vista, CA, 9/2/10 - Green Day - Awesome as Fuck
I'm Not A Vampire - Revamped - Falling In Reverse - I'm Not A Vampire (Revamped)
Money Game, Pt. 2 - Ren - Demos (Do Not Share), Vol 1
Dead Body - Call Me Karizma - Dead Body
Simba - Ernia - 68
Futura Ex (feat. Ernia) - Gu√®, Ernia - GVESVS
Losing My Religion - Movements - Losing My Religion
Nothin' But A Good Time - Remastered 2006 - Poison - Open Up And Say...Ahh! (20th Anniversary Edition)
Feeling - Ernia - Come Uccidere Un Usignolo (67 Edition)
ROSE & FIORI - Ernia - IO NON HO PAURA
Chokehold - Will Ramos, Nik Nocturnal - Chokehold
DISPOSABLE FIX - The Plot In You - DISPOSE
Hey Ya - Sleep Token - Hey Ya
Take Me Back To Eden - Sleep Token - Take Me Back To Eden
Hi Ren - Ren - Hi Ren
I Guess I Just Feel Like - John Mayer - Sob Rock
What's New Scooby-Doo? - Simple Plan - What's New Scooby-Doo?
