Stereo Love - Twelve Remix - Edward Maya, Vika Jigulina, Twelve - Stereo Love (Remixes)
Apologize - Besomorph, Anthony Keyrouz, Lunis - Apologize
Zombie (Zombic & Felix Schorn Remix) - Besomorph, N3WPORT, Lunis, Zombic, Felix Schorn - Zombie (Zombic & Felix Schorn Remix)
Falling - Besomorph, N3WPORT, Meo - Falling
Sweet Dreams (Scott Rill Remix) - Besomorph, Bolshiee, Scott Rill - Sweet Dreams (Scott Rill Remix)
Umbrella (with Marnik) - Hard Lights, Moonshine, Marnik, Ember Island - Umbrella (with Marnik)
What I've Done - Besomorph, Behmer, Lunis - What I've Done
Radioactive - Coopex, Yohan Gerber, Nito-Onna - Radioactive
Habits (Stay High) - Arcando, Nito-Onna - Habits (Stay High)
I Kissed A Girl - Sunlike Brothers, LANNÉ, Courtney Drummey - I Kissed A Girl
Heroes - Coopex, New Beat Order, Nito-Onna - Heroes
Now You're Gone - Robbe, Fyex, Derrick Ryan - Now You're Gone
Titanium - WHOCARES, LOUKA - Titanium
SAD - Rasster, Erin Bloomer - SAD
Diamonds - Braaheim - Diamonds
Somebody Told Me - Ascence, KAIYS - Somebody Told Me
Seven Nation Army - Dantec, MISERO - Seven Nation Army
Bad Habits - 4URA, Thatsimo, Stella Key - Bad Habits
I Gotta Feeling - Black Eyed Peas - THE E.N.D. (THE ENERGY NEVER DIES) [Deluxe Version]
Pump It - Black Eyed Peas - Monkey Business
Let's Get It Started - Spike Mix - Black Eyed Peas - Elephunk
Boom Boom Pow - Black Eyed Peas - THE E.N.D. (THE ENERGY NEVER DIES) [Deluxe Version]
Numb - Arc North, Aaron Richards, New Beat Order, Cour - Numb
Mood (feat. iann dior) - 24kGoldn, iann dior - El Dorado
Wrecking Ball - Miley Cyrus - Bangerz (Deluxe Version)
Wake Me Up - Avicii - True
Ni**as In Paris - JAY-Z, Kanye West - Watch The Throne (Deluxe)
Party Rock Anthem - LMFAO, Lauren Bennett, GoonRock - Sorry For Party Rocking
Bangarang (feat. Sirah) - Skrillex, Sirah - Bangarang EP
goosebumps - Travis Scott - Birds In The Trap Sing McKnight
Man's Not Hot - Big Shaq - Man's Not Hot
The Time (Dirty Bit) - Black Eyed Peas - The Beginning
XO Tour Llif3 - Lil Uzi Vert - Luv Is Rage 2
Animals - Martin Garrix - Animals
Baby Don't Hurt Me - David Guetta, Anne-Marie, Coi Leray - Baby Don't Hurt Me
Fireworks (feat. Moss Kena & The Knocks) - Purple Disco Machine, Moss Kena, The Knocks - Exotica
Goosebumps - Remix - Travis Scott, HVME - Goosebumps (Remix)
Smells Like Teen Spirit - Coopex, Nito-Onna, CPX - Smells Like Teen Spirit
Now You're Gone (feat. DJ Mental Theo's Bazzheadz) - Video Edit - Basshunter, DJ Mental Theos Bazzheadz - Now You're Gone - The Album
Sandstorm - Radio Edit - Darude - Sandstorm
Animals - Radio Edit - Martin Garrix - Animals
Mask Off - Marshmello Remix - Future, Marshmello - Mask Off (Marshmello Remix)
Fight Back - NEFFEX - Fight Back: The Collection
Violence - Original Mix - Grimes, i_o - Miss Anthropocene (Deluxe Edition)
My Name is Dark - Art Mix - Grimes - Miss Anthropocene (Deluxe Edition)
±ªþ³§ (feat. Yonaka) - Bring Me The Horizon, YONAKA - Music to listen to~dance to~blaze to~pray to~feed to~sleep to~talk to~grind to~trip to~breathe to~help to~hurt to~scroll to~roll to~love to~hate to~learn Too~plot to~play to~be to~feel to~breed to~sweat to~dream to~hide to~live to~die to~GO TO
Heart On Fire - Besomorph, Adam Woods - Heart On Fire
Shinigami Eyes - Grimes - Shinigami Eyes
We Appreciate Power - Algorithm Mix - Grimes, HANA - We Appreciate Power (Algorithm Mix)
Toxic - Y2K & Alexander Lewis Remix - Britney Spears, Y2K, Alexander Lewis - Toxic (Y2K & Alexander Lewis Remix)
Memories (feat. Kid Cudi) - 2021 Remix - David Guetta, Kid Cudi - Memories (feat. Kid Cudi) [2021 Remix]
Bad Habits - MEDUZA Remix - Ed Sheeran, MEDUZA - Bad Habits (MEDUZA Remix)
SAD - Imanbek xxx Remix - Rasster, Erin Bloomer, Imanbek - SAD (Imanbek xxx Remix)
Tripwire - YMIR - Tripwire
DiE4u - Bring Me The Horizon - DiE4u
Dummy (with Oli Sykes of Bring Me The Horizon) - Cheat Codes, Oli Sykes, Bring Me The Horizon - HELLRAISERS, Part 2
Can You Feel My Heart - Remix - Bring Me The Horizon, Jeris Johnson - Can You Feel My Heart (Remix)
Seven Nation Army - The Glitch Mob Remix - The White Stripes, The Glitch Mob - Seven Nation Army (The Glitch Mob Remix)
Story Of My Life (feat. Trippie Redd) - Heavy Edit - ILLENIUM, Sueco, Trippie Redd - Story Of My Life (feat. Trippie Redd) [Heavy Edit]
Unbound - Excision, Sullivan King - Unbound
11 Minutes (feat. Travis Barker) - Kayzo Remix - YUNGBLUD, Travis Barker, Kayzo - 11 Minutes (feat. Travis Barker) [Kayzo Remix]
Never Let You Down (with TELLE) - Kayzo, TELLE - Never Let You Down (with TELLE)
Everytime We Touch - Hardwell & Maurice West Remix - Cascada, Maurice West - Everytime We Touch (Hardwell & Maurice West Remix)
( The Dreamer's Hotel) (Bob Vylan Remix) - Enter Shikari, Bob Vylan - { The Dreamer's Hotel } (Bob Vylan Remix)
The Void Stares Back - Enter Shikari, WARGASM (UK) - The Void Stares Back
Live Outside - Shikari Sound System Remix - Enter Shikari, Shikari Sound System - Live Outside (Shikari Sound System Remix)
Anaesthetist - Koven Remix - Enter Shikari - Anaesthetist
Rabble Rouser - Edit - Enter Shikari - Rabble Rouser (Edit)
One More Time - Daft Punk - Discovery
Around the World - Daft Punk - Homework
Harder, Better, Faster, Stronger - Daft Punk - Discovery
Doin' it Right (feat. Panda Bear) - Daft Punk, Panda Bear - Random Access Memories
Give Life Back to Music - Daft Punk - Random Access Memories
Replay - Iyaz - Replay
Give Me Everything (feat. Nayer) - Pitbull, AFROJACK, Ne-Yo, Nayer - Planet Pit (Deluxe Version)
Don't You Worry Child - Radio Edit - Swedish House Mafia, John Martin - Don't You Worry Child
When Love Takes Over (feat. Kelly Rowland) - David Guetta, Kelly Rowland - One More Love
Wake Me Up - Radio Edit - Avicii - True
Titanium (feat. Sia) - David Guetta, Sia - Nothing but the Beat (Ultimate Edition)
Just Dance - Lady Gaga, Colby O'Donis - The Fame
Let's Get It Started - Black Eyed Peas - Let's Get It Started
Ma cherie - Dj Antoine Vs Mad Mark 2K12 Radio Edit - DJ Antoine, The Beatshakers, DJ Antoine vs. Mad Mark - Ma cherie
4 Minutes (feat. Justin Timberlake & Timbaland) - Madonna, Justin Timberlake, Timbaland - Celebration (double disc version)
Payphone - Maroon 5, Wiz Khalifa - Overexposed Track By Track
Good Feeling - Flo Rida - Wild Ones
Sing La La La - E-Partment Short Mix - Carolina Marquez, Flo Rida, Dale Saunders, E-Partment - Sing La La La
Better Off Alone - Alice Deejay - Who Needs Guitars Anyway?
Infinity 2008 - Klaas Vocal Edit - Guru Josh Project, Klaas - Infinity 2008
World, Hold On - Bob Sinclair, Steve Edwards - Noah's Arc Soundtrack
Blue (Da Ba Dee) - Gabry Ponte Ice Pop Radio - Eiffel 65, Gabry Ponte - Europop
All I Ever Wanted - Radio Edit - Basshunter - Now You're Gone
Dragostea Din Tei - Romanian Version - O-Zone - Dragostea Din Tei
When Love Takes Over (feat. Kelly Rowland) - David Guetta, Kelly Rowland - One Love (Deluxe)
What Is Love - Haddaway - The Album
Everytime We Touch - Cascada - Everytime We Touch
Memories (feat. Kid Cudi) - David Guetta, Kid Cudi - One More Love
Beautiful Monster - Ne-Yo - Libra Scale
Closer - Ne-Yo - Year Of The Gentleman
Yeah! (feat. Lil Jon & Ludacris) - USHER, Lil Jon, Ludacris - Confessions (Expanded Edition)
DJ Got Us Fallin' In Love (feat. Pitbull) - USHER, Pitbull - Raymond v Raymond (Expanded Edition)
