That Face - Frank Sinatra Jr. - That Face!
C'est Magnifique - Remastered - Kay Starr - Movin' On Broadway
Kiss Me In The Morning - The Eddy - The Eddy (From The Netflix Original Series)
Come Fly With Me - Remastered 1998 - Frank Sinatra - Come Fly With Me (Expanded Edition)
That's Life - Frank Sinatra - That's Life
My Way - Frank Sinatra - My Way (Expanded Edition)
Fly Me To The Moon (In Other Words) - Frank Sinatra, Count Basie - Sinatra/Basie: The Complete Reprise Studio Recordings
Theme From New York, New York - Frank Sinatra - Trilogy: Past, Present & Future
I've Got You Under My Skin - Remastered 1998 - Frank Sinatra - Songs For Swingin' Lovers! (Remastered)
Body And Soul - Teddy Wilson, Benny Carter - The Quintessence Teddy Wilson New York-Chicago 1933-1950
It's Oh So Quiet - Betty Hutton - The Best of the RCA Years
Every Little Movement - Dwight Batteau, Mario Grigorov - Atomic Lounge
Strangers In The Night - Frank Sinatra - Strangers In The Night (Expanded Edition)
Trying To Get To You - Second 'Sit-Down' Show - Live - Elvis Presley - The Best of The '68 Comeback Special (Live)
Don't Be Cruel - Elvis Presley - Elvis 30 #1 Hits
Love Me Tender - Elvis Presley - Elvis 30 #1 Hits
Jailhouse Rock - Elvis Presley - Elvis 30 #1 Hits
One Night - Elvis Presley - Elvis 30 #1 Hits
It's Now or Never - Elvis Presley - Elvis 30 #1 Hits
Can't Help Falling In Love - Elvis Presley - Elvis 30 #1 Hits
A Little Less Conversation - JXL Radio Edit Remix - Elvis Presley, Junkie XL - Elvis 30 #1 Hits
Burning Love - Elvis Presley - Elvis 30 #1 Hits
Suspicious Minds - Elvis Presley - Elvis 30 #1 Hits
No, Never - Skeeter Davis - The Essential Skeeter Davis
Heartbreak Hotel - Elvis Presley - Elvis 30 #1 Hits
Miss You Like Crazy - Natalie Cole - Good To Be Back
Unforgettable - Natalie Cole, Nat King Cole - Unforgettable: With Love
Maramao perchè sei morto - Trio Lescano - The Italian Song - Trio Lescano, Volume 2
Come prima - Tony Dallara - I grandi successi di Tony Dallara: le più belle canzoni di sempre
I Want to Know What Love Is - 1999 Remaster - Foreigner - Agent Provocateur
Ain't No Mountain High Enough - Marvin Gaye, Tammi Terrell - United
The Way You Look Tonight - Frank Sinatra - Days Of Wine And Roses, Moon River And Other Academy Award Winners
My Girl - The Temptations - The Temptations Sing Smokey
I Heard It Through The Grapevine - Marvin Gaye - In The Groove
Best of My Love - The Emotions - Rejoice
Respect - Aretha Franklin - I Never Loved a Man the Way I Love You
Wouldn't It Be Nice - The Beach Boys - Pet Sounds (Original Mono & Stereo Mix)
Mr. Blue Sky - Electric Light Orchestra - Out of the Blue
La vie en rose - Single Version - Louis Armstrong - Highlights From His Decca Years
Stormy Weather - Etta James - At Last!
Lean on Me - Bill Withers - Still Bill
Rich Girl - Daryl Hall & John Oates - Bigger Than Both Of Us
Listen to the Music - The Doobie Brothers - Toulouse Street
Give A Little Bit - Supertramp - Even In The Quietest Moments
I Say a Little Prayer - Aretha Franklin - Aretha Now
You're The First, The Last, My Everything - Single Version - Barry White - You're The First, The Last, My Everything
At Last - Etta James - At Last!
Dream A Little Dream Of Me - Louis Armstrong - What A Wonderful World
The Way You Look Tonight - Tony Bennett - Rarities, Outtakes & Other Delights, Vol. 2
For Once In My Life - Stevie Wonder - For Once In My Life
Lovely Day - Bill Withers - Menagerie
Tired of Being Alone - Al Green - Gets Next to You
Signed, Sealed, Delivered (I'm Yours) - Stevie Wonder - Signed, Sealed And Delivered
I Can't Help Myself (Sugar Pie, Honey Bunch) - Four Tops - Four Tops Second Album
Build Me Up Buttercup - The Foundations - From the Foundations (Expanded Edition)
Do You Believe in Magic? - The Lovin' Spoonful - Do you Believe In Magic
Uptown Girl - Billy Joel - An Innocent Man
Just the Way You Are - Billy Joel - The Stranger (Legacy Edition)
Let's Stay Together - Al Green - Let's Stay Together
Can't Get Enough Of Your Love, Babe - Barry White - Can't Get Enough
Got to Get You Into My Life - Earth, Wind & Fire - The Best Of Earth, Wind & Fire Vol. 1
Unchained Melody - The Righteous Brothers - Just Once In My Life
I'll Be There - The Jackson 5 - Third Album
After the Love Has Gone - Earth, Wind & Fire - I Am
I Will Always Love You - Whitney Houston - The Bodyguard - Original Soundtrack Album
Stand By Me - Ben E. King - Don't Play That Song (Mono)
Don't Go Breaking My Heart - Elton John, Kiki Dee - Rock Of The Westies
You Can't Hurry Love - 2016 Remaster - Phil Collins - Hello, I Must Be Going! (Deluxe Edition)
Easy Lover - Philip Bailey, Phil Collins - Chinese Wall (Expanded Edition)
Walking On Sunshine - Katrina & The Waves - Katrina & The Waves
Can't Help Falling in Love - Elvis Presley - Blue Hawaii
(You Make Me Feel Like) A Natural Woman - Aretha Franklin - Lady Soul (With Bonus Selections)
What A Wonderful World - Louis Armstrong - What A Wonderful World
Piano Man - Billy Joel - Piano Man (Legacy Edition)
Easy - Commodores - Commodores
Midnight Train to Georgia - Gladys Knight & The Pips - Imagination (Expanded Edition)
Back Stabbers - The O'Jays - Back Stabbers
Best Thing That Ever Happened to Me - Gladys Knight & The Pips - Imagination (Expanded Edition)
Theme From New York, New York - 2008 Remastered - Frank Sinatra - Nothing But The Best (2008 Remastered)
Your Song - Elton John - Elton John
How Deep Is Your Love - Bee Gees - How Can You Mend A Broken Heart
If You Leave Me Now - Chicago - Chicago X
Come Fly With Me - 2008 Remastered - Frank Sinatra - Nothing But The Best (2008 Remastered)
My Girl - Otis Redding - Otis Blue: Otis Redding Sings Soul (Collector's Edition)
Moon River - Frank Sinatra - Days Of Wine And Roses, Moon River And Other Academy Award Winners
(Sittin' On) the Dock of the Bay - Otis Redding - The Dock of the Bay (Mono)
Ain't No Sunshine - Bill Withers - Just As I Am
Now That We Found Love - The O'Jays - Ship Ahoy (Expanded Edition)
Let's Do It Again - The Staple Singers - Faith And Grace: A Family Journey 1953-1976
Me and Mrs. Jones - Billy Paul - 360 Degrees of Billy Paul (Expanded Edition)
It's A Man's, Man's, Man's World - James Brown & The Famous Flames - It's A Man's Man's Man's World
Heart of Gold - Charles Bradley, Menahan Street Band - No Time For Dreaming
Get out of My Life Woman - Lee Dorsey - Wheelin' And Dealin' - The Definitive Collection
Luscious Lady - Darondo - Listen to My Song: The Music City Sessions
Can You Get To That - Funkadelic - Maggot Brain
Reach Out I'll Be There - Four Tops - Reach Out
Moon River - Louis Armstrong - Hello, Dolly! (Remastered)
Blue Moon - Ella Fitzgerald - Ella Fitzgerald Sings The Rodgers And Hart Song Book
Let's Get It On - Marvin Gaye - Let's Get It On (Deluxe Edition)
What's Going On - Marvin Gaye - What's Going On
