Tear in My Heart - Twenty One Pilots - Blurryface
New Light - John Mayer - Sob Rock
Mary On A Cross - Ghost - Seven Inches Of Satanic Panic
The Funeral - YUNGBLUD - YUNGBLUD
why are you here - mgk - mainstream sellout (life in pink deluxe)
Snap Out Of It - Arctic Monkeys - AM
Running in the Night - FM-84, Ollie Wride - Atlas
DANCE WITH ME - blink-182 - ONE MORE TIME...
1979 - The Contortionist - Our Bones
See You Again (feat. Kali Uchis) - Tyler, The Creator, Kali Uchis - Flower Boy
maybe (feat. Bring Me The Horizon) - mgk, Bring Me The Horizon - mainstream sellout
kiss kiss - mgk - Tickets To My Downfall
drunk face - mgk - Tickets To My Downfall
make up sex (feat. blackbear) - mgk, blackbear - mainstream sellout
papercuts - album edit - mgk - mainstream sellout
jawbreaker - mgk - Tickets To My Downfall
Mardy Bum - Arctic Monkeys - Whatever People Say I Am, That's What I'm Not
Your Body Is a Wonderland - John Mayer - Room For Squares
Suck It and See - Arctic Monkeys - Suck It and See
Love on the Weekend - John Mayer - The Search for Everything
Mood (feat. iann dior) - 24kGoldn, iann dior - El Dorado
Wild Blue - John Mayer - Sob Rock
Carry Me Away - John Mayer - Sob Rock
Perfectly Lonely - John Mayer - Battle Studies
Good Looking - Suki Waterhouse - Good Looking
Again - Lenny Kravitz - Again
goosebumps - Travis Scott - Birds In The Trap Sing McKnight
Happy Together (feat. Ray Toro) - Gerard Way, Ray Toro - Happy Together (feat. Ray Toro)
What's the Use? - Mac Miller - Swimming
Ladders - Mac Miller - Swimming
Figure It Out - Royal Blood - Royal Blood
Sick and Tired (ft. Machine Gun Kelly and Travis Barker) - iann dior, mgk, Travis Barker - I'm Gone
Scar Tissue - Red Hot Chili Peppers - Californication (Deluxe Edition)
Heroes - 2017 Remaster - David Bowie - "Heroes" (2017 Remaster)
Footloose - From "Footloose" Soundtrack - Kenny Loggins - Footloose (Original Motion Picture Soundtrack)
Misunderstood - Bon Jovi - Bounce
Bad Medicine - Bon Jovi - New Jersey (Deluxe Edition)
It's My Life - Bon Jovi - Crush
This House Is Not For Sale - Bon Jovi - This House Is Not For Sale
Bed Of Roses - Bon Jovi - Keep The Faith
TAXI DRIVER - Rkomi - TAXI DRIVER
Running Out Of Time - Paramore - This Is Why
Fluorescent Adolescent - Arctic Monkeys - Favourite Worst Nightmare
NYE [Feat. Suki Waterhouse] - Local Natives, Suki Waterhouse - NYE [Feat. Suki Waterhouse]
R U Mine? - Arctic Monkeys - AM
Do Me a Favour - Arctic Monkeys - Favourite Worst Nightmare
2all - Catfish and the Bottlemen - It's a Music Match - Rock
City Of Stars - Hollywood Remix - Ryan Gosling, Emma Stone - City Of Stars (Hollywood Remix)
